&&&&&&&&&&&&&&&&&&&&&&&&&&&&&&&&&&&&&&&&&&&&&&&&&&&&&&&&&&&&&&&&&&&&&&&&&&&&%%%
&**********************************************************&                % %
&********+--+--+--+--+--+--+--+--+--+--+--+--+--+--+--+****&                %%%
&********I        |           |           |     |     |****&                  &
&********+--+  +  +  +--+--+  +  +--+--+--+  +  +  +  +****&                  &
&********|     |  |        |  |  |           |  |  |  |****&                  &
&********+  +--+--+--+--+--+  +  +  +--+--+--+  +--+  +****&                  &
&********|  |        |     |  |     |     |  |        |****&                  &
&********+  +--+--+  +  +  +  +--+--+  +  +  +  +  +--+****&                  &
&********|     |  |     |  |  |     |  |     |  |  |  |****&                  &
&********+--+  +  +--+--+  +  +--+  +  +  +--+--+  +  +****&                  &
&********|     |              |     |  |     |     |  |****&                  &
&********+  +--+--+  +--+--+--+  +--+  +--+  +  +--+  +****&                  &
&********|  |     |     |     |     |     |  |        |****&                  &
&********+  +  +  +--+  +--+  +--+  +--+  +  +--+--+  +****&                  &
&********|  |  |     |     |     |        |     |     |****&                  &
&********+  +  +--+  +--+  +--+  +--+  +--+--+--+  +  +****&                  &
&********|     |           |        |  |           |  |****&                  &
&********+--+--+  +  +--+  +  +--+--+  +  +--+--+--+  +****&                  &
&********|  |     |     |     |     |     |     |     |****&                  &
&********+  +  +--+  +  +--+--+--+  +  +--+  +--+  +  +****&                  &
&********|     |     |                 |           |  F****&    q - voltar    &
&********+--+--+--+--+--+--+--+--+--+--+--+--+--+--+--+****&                  &
&&&&&&&&&&&&&&&&&&&&&&&&&&&&&&&&&&&&&&&&&&&&&&&&&&&&&&&&&&&&&&&&&&&&&&&&&&&&&&&
